[[1,1,1,1,1,1,1,1,1,1,1],
 [1,0,0,0,0,0,0,0,0,0,1],
 [1,0,1,1,1,0,1,1,1,0,1],
 [1,0,1,0,1,0,1,0,1,0,1],
 [1,0,1,0,1,0,1,0,1,0,1],
 [1,0,1,0,1,0,1,0,1,0,1],
 [1,0,1,0,1,0,1,0,1,0,1],
 [1,0,1,0,1,0,1,0,0,0,1],
 [1,0,1,0,1,0,1,1,1,0,1],
 [1,0,0,0,0,0,0,0,1,0,1],
 [1,1,1,1,1,1,1,1,1,1,1]]
// start (9,1)
// end   (9,9)
